



R 1920 1080

F 51,51,51

1111111111
1000000001
1000000001
1000000001
1000000N01
1000000001
1111111111
