F    25, 0, 250           

      
R 1920  1080



C   12,      255, 0     




NO ./textures/coucou.xpm    
SO ./textures/test.xpm 
WE ./textures/hello.xpm
S ./textures/sprites.xpm   
EA ./textures/oui.xpm  


    111111
  1 1
110111111111111111111111111
100000000000000000000000001
100000002000000000000000001
10000000000000N000000000001
111110000000000000000000001
10000000000000000000000001
111111111111111111111111111