F 12,25, 25

R 1920 1080 

C  45,255, 12 

NO ./textures/coucou.xpm    
SO ./textures/test.xpm 
WE ./textures/hello.xpm
S ./textures/sprites.xpm   
EA ./textures/oui.xpm  

    111111
  1 
110111111111111111111111111
100000000000000000000000001
100000002000000000000000001
10000000000000N000000000001
1111100000000000000000000011111111111
100000000000000000000000011111
1111111111111111111111111111111