F 25, 0,                     250

R 1920 1080

C 12,255, 0-

1111111111
1000000001
1000000001
1000000001
1000000N01
1000000001
1111111111
