R    1920 1080

NO ./textures/naruto1.xpm
WE ./textures/WOLF4.xpm


SO ./textures/WOLF3.xpm
S ./textures/Barrel.xpm

F  0, 128, 0

C 255, 165, 0

EA ./textures/WOLF6.xpm

111111111111111111111111111
10000000000000000000000001
10000000000000000000000001
100000000000000N0000000001
111110000000000000000000001
100000000000001000000000001
111111111111111111111111111