F    25, 0, 250           

      
R 1920  1080



C   12,      255, 0     




NO ./textures/coucou.xpm    
SO ./textures/test.xpm 
WE ./textures/hello.xpm
S ./textures/sprites.xpm   
EA ./textures/oui.xpm   


        1
      1110111111111111111111
    1111000000001
    100200001111111
    1000000001
    1000000N01
    1000000001
    1111111111