R 1920 1080

1111111111
1000000001
1000000001
1000000001
1000000N01
1000000001
1111111111
