NO ./textures/WOLF2.xpm
WE ./textures/WOLF1.xpm

SO ./textures/WOLF1.xpm

F  255, 255, 255

C 255, 165, 0

EA ./textures/WOLF1.xpm

111111111111111111111111111
10000000000000000000000001
10000000000000000000000001
100000000000000000000000011
111110000000000000000000001
1000000000000010000000000N1
111111111111111111111111111