NO ./textures/naruto2.xpm
WE ./textures/naruto2.xpm

SO ./textures/naruto2.xpm
S ./textures/Barrel.xpm

F  255, 255, 255

C 255, 165, 0

EA ./textures/naruto2.xpm

111111111111111111111111111
10000000000000000000000001
10000000000000000000000001
10000000000000000S00000011
111110000000000000000000001
100000000000001000000000001
111111111111111111111111011